"filename", "language", "Python", "C++", "YAML", "CSV", "comment", "blank", "total"
"/Users/ninothomasliner/Documents/GitHub/main/Controls/v1/actual_states_log.csv", "CSV", 0, 0, 0, 5001, 0, 1, 5002
"/Users/ninothomasliner/Documents/GitHub/main/Controls/v1/import unittest.py", "Python", 67, 0, 0, 0, 0, 17, 84
"/Users/ninothomasliner/Documents/GitHub/main/Controls/v1/imu_test.cpp", "C++", 0, 80, 0, 0, 38, 35, 153
"/Users/ninothomasliner/Documents/GitHub/main/Controls/v1/simulation_test.py", "Python", 107, 0, 0, 0, 60, 68, 235
"/Users/ninothomasliner/Documents/GitHub/main/Controls/v1/single_agent_controller/controllers/__init__.py", "Python", 0, 0, 0, 0, 0, 1, 1
"/Users/ninothomasliner/Documents/GitHub/main/Controls/v1/single_agent_controller/controllers/ca_motor.py", "Python", 22, 0, 0, 0, 8, 20, 50
"/Users/ninothomasliner/Documents/GitHub/main/Controls/v1/single_agent_controller/controllers/ca_system.py", "Python", 35, 0, 0, 0, 4, 18, 57
"/Users/ninothomasliner/Documents/GitHub/main/Controls/v1/single_agent_controller/controllers/low_level_ctrl_2.py", "Python", 262, 0, 0, 0, 10, 94, 366
"/Users/ninothomasliner/Documents/GitHub/main/Controls/v1/single_agent_controller/controllers/pid_ctrl.py", "Python", 53, 0, 0, 0, 6, 22, 81
"/Users/ninothomasliner/Documents/GitHub/main/Controls/v1/single_agent_controller/controllers/pid_ctrl_w_error.py", "Python", 37, 0, 0, 0, 6, 22, 65
"/Users/ninothomasliner/Documents/GitHub/main/Controls/v1/single_agent_controller/controllers_utils/__init__.py", "Python", 0, 0, 0, 0, 0, 1, 1
"/Users/ninothomasliner/Documents/GitHub/main/Controls/v1/single_agent_controller/controllers_utils/helpers.py", "Python", 78, 0, 0, 0, 7, 20, 105
"/Users/ninothomasliner/Documents/GitHub/main/Controls/v1/single_agent_simulator/x/__init__.py", "Python", 0, 0, 0, 0, 0, 1, 1
"/Users/ninothomasliner/Documents/GitHub/main/Controls/v1/single_agent_simulator/x/ode_solver.py", "Python", 21, 0, 0, 0, 3, 13, 37
"/Users/ninothomasliner/Documents/GitHub/main/Controls/v1/single_agent_simulator/x/system_dynamics.py", "Python", 76, 0, 0, 0, 23, 23, 122
"/Users/ninothomasliner/Documents/GitHub/main/Controls/v1/single_agent_simulator/y/helpers.py", "Python", 122, 0, 0, 0, 6, 34, 162
"/Users/ninothomasliner/Documents/GitHub/main/Controls/v1/single_agent_simulator/y/iterate.py", "Python", 14, 0, 0, 0, 0, 4, 18
"/Users/ninothomasliner/Documents/GitHub/main/Controls/v1/single_agent_simulator/y/pos_ang_integrator.py", "Python", 6, 0, 0, 0, 0, 5, 11
"/Users/ninothomasliner/Documents/GitHub/main/Controls/v1/single_agent_simulator/y/sim.py", "Python", 8, 0, 0, 0, 2, 5, 15
"/Users/ninothomasliner/Documents/GitHub/main/Controls/v1/single_agent_simulator/y/sim_config.yaml", "YAML", 0, 0, 26, 0, 3, 5, 34
"/Users/ninothomasliner/Documents/GitHub/main/Controls/v1/single_agent_simulator/y/six_dof_model.py", "Python", 93, 0, 0, 0, 31, 32, 156
"/Users/ninothomasliner/Documents/GitHub/main/Controls/v1/single_agent_visualiser/__init__.py", "Python", 0, 0, 0, 0, 0, 1, 1
"/Users/ninothomasliner/Documents/GitHub/main/Controls/v1/single_agent_visualiser/log_visualiser.py", "Python", 33, 0, 0, 0, 3, 13, 49
"/Users/ninothomasliner/Documents/GitHub/main/Controls/v1/single_agent_visualiser/new_visualiser.py", "Python", 40, 0, 0, 0, 7, 12, 59
"/Users/ninothomasliner/Documents/GitHub/main/Controls/v1/single_agent_visualiser/vector_visualiser.py", "Python", 39, 0, 0, 0, 4, 17, 60
"/Users/ninothomasliner/Documents/GitHub/main/Controls/v1/utils/__init__.py", "Python", 2, 0, 0, 0, 1, 1, 4
"/Users/ninothomasliner/Documents/GitHub/main/Controls/v1/utils/constants.yaml", "YAML", 0, 0, 79, 0, 1, 17, 97
"/Users/ninothomasliner/Documents/GitHub/main/Controls/v1/utils/constants2.py", "Python", 34, 0, 0, 0, 10, 16, 60
"/Users/ninothomasliner/Documents/GitHub/main/Controls/v1/utils/constants_loader.py", "Python", 7, 0, 0, 0, 0, 1, 8
"/Users/ninothomasliner/Documents/GitHub/main/Controls/v1/utils/helpers.py", "Python", 0, 0, 0, 0, 0, 1, 1
"/Users/ninothomasliner/Documents/GitHub/main/Controls/v1/utils/llc_controller_testcases.py", "Python", 87, 0, 0, 0, 1, 31, 119
"/Users/ninothomasliner/Documents/GitHub/main/Controls/v1/utils/waypoints.py", "Python", 18, 0, 0, 0, 1, 2, 21
"/Users/ninothomasliner/Documents/GitHub/main/Controls/v1/zz_complete_controller_test.py", "Python", 80, 0, 0, 0, 19, 41, 140
"/Users/ninothomasliner/Documents/GitHub/main/Controls/v1/zz_roll_pitch_yaw_test.py", "Python", 57, 0, 0, 0, 12, 34, 103
"Total", "-", 1398, 80, 105, 5001, 266, 628, 7478